1,2,3,4,5,6,7,8,9,1
1,1,1,1,5,1,1,9,8,1
1,1,1,1,1,1,9,1,1,8
1,0,0,0,1,9,0,0,0,1
1,0,0,0,9,1,0,0,0,1
1,1,1,9,1,1,1,1,1,1
1,1,9,1,1,1,1,1,1,1
1,9,1,1,2,1,3,1,1,1
1,1,1,1,1,1,1,1,1,1
1,1,1,1,6,7,1,1,1,1